15,15,15,15,15,15,15,15,15,15,15,15,15,15,15,15,15,15,15,15,15,15,15,15,15,15,15,15,15,15,15,15
15,15,15,0,11,0,0,11,0,0,11,0,0,12,0,12,0,15,15,15,15,15,15,0,11,0,15,15,15,15,15,15
15,15,11,0,11,0,0,11,0,3,11,0,0,12,0,12,0,0,15,15,15,15,0,0,11,0,0,15,15,15,15,15
15,0,11,0,11,0,0,11,0,0,11,0,0,12,0,12,0,0,0,15,15,0,0,0,15,0,0,0,15,15,15,15
15,0,11,0,15,0,0,15,0,0,15,0,0,15,0,12,0,0,0,15,0,0,0,0,0,0,0,0,0,15,15,15
15,0,11,0,0,0,0,0,0,0,0,0,0,0,0,12,0,0,15,0,0,0,15,15,15,15,15,0,0,0,15,15
15,0,15,0,0,0,0,0,0,0,0,0,0,0,0,15,0,15,0,0,0,15,0,0,0,0,0,15,0,0,0,15
15,0,0,0,0,0,0,0,0,0,0,0,0,10,10,0,0,15,0,0,15,0,0,0,0,0,0,0,15,0,0,15
15,15,0,0,0,0,0,0,0,0,0,0,0,15,15,0,15,0,0,15,0,0,0,0,0,0,0,0,0,0,0,15
15,15,15,0,0,0,0,0,0,5,0,0,0,15,0,0,0,0,0,15,0,0,4,0,0,0,0,0,0,0,15,15
15,15,15,15,15,15,15,15,15,15,0,0,0,15,7,0,1,0,15,15,0,0,15,15,15,15,15,15,15,15,15,15
15,15,15,0,0,0,0,0,0,0,0,0,15,15,15,15,15,15,15,15,0,0,0,0,0,0,0,15,15,15,15,15
15,15,0,0,0,0,0,0,0,0,0,0,0,15,0,12,0,0,12,0,15,0,0,0,0,0,0,0,0,15,15,15
15,0,0,0,0,0,15,15,15,15,15,0,0,0,0,12,0,0,12,0,15,15,15,15,15,15,0,0,0,0,15,15
15,0,0,0,0,15,0,0,0,0,15,15,0,0,0,15,0,0,15,0,15,15,15,0,0,0,15,0,0,0,0,15
15,0,0,0,15,0,0,0,0,0,0,0,0,15,10,10,10,10,10,10,15,15,0,0,0,0,0,15,0,0,0,15
15,15,0,0,15,0,0,0,0,0,0,0,15,15,15,15,15,15,15,15,15,0,0,0,0,0,0,15,0,0,15,15
15,0,0,0,15,0,0,0,0,0,0,15,15,0,11,0,0,11,0,0,11,0,0,0,0,0,0,15,0,0,0,15
15,0,0,15,15,15,0,0,0,0,15,0,0,0,11,0,0,11,0,0,11,0,0,0,0,0,15,15,15,0,0,15
15,0,0,0,0,15,15,15,15,15,6,0,0,0,11,0,0,11,0,0,11,0,0,0,0,15,15,0,0,0,0,15
15,15,0,0,0,0,0,0,0,0,0,0,0,0,11,0,0,11,0,0,11,0,0,15,15,15,0,0,0,0,0,15
15,15,15,0,0,0,0,0,0,0,0,0,0,0,15,0,0,15,0,0,15,0,0,0,0,0,0,0,0,0,15,15
15,15,15,15,5,0,0,0,0,0,0,0,0,0,0,0,0,0,0,0,0,0,0,0,0,0,0,0,4,15,15,15
15,15,15,15,15,15,15,15,15,15,15,15,15,15,15,15,15,15,15,15,15,15,15,15,15,15,15,15,15,15,15,15
