15,15,15,15,15,15,15,15,15,15,15,15,15,15,15,15,15,15,15,15,15,15,15,15,15,15,15,15,15,15,15,15
15,15,0,0,0,11,0,0,0,0,0,12,0,11,0,15,15,0,12,0,11,0,0,0,0,0,12,0,0,0,15,15
15,15,0,0,0,11,0,0,0,0,0,12,0,11,0,9,9,0,12,0,11,0,0,0,0,0,12,0,0,0,15,15
15,15,8,0,0,11,8,8,8,8,8,12,0,11,0,0,0,0,12,0,11,8,8,8,8,8,12,0,0,8,15,15
15,15,15,0,0,15,15,15,15,15,15,15,0,11,0,0,0,0,12,0,15,15,15,15,15,15,15,0,0,15,15,15
15,0,0,8,8,0,0,0,9,9,9,9,0,11,8,8,8,8,12,0,9,9,9,9,0,0,0,8,8,0,0,15
15,0,8,15,15,8,0,0,0,0,0,0,0,15,15,15,15,15,15,0,0,0,0,0,0,0,8,15,15,8,0,15
15,0,15,0,0,15,8,0,0,0,0,0,0,0,0,0,0,0,0,0,0,0,0,0,0,8,15,0,0,15,0,15
15,8,0,0,0,11,15,13,8,8,8,8,8,8,8,8,5,8,8,8,8,8,8,8,14,15,12,0,0,0,8,15
15,15,8,0,0,11,0,15,15,15,15,15,15,15,15,15,15,15,15,15,15,15,15,15,15,0,12,0,0,8,15,15
15,0,15,8,0,11,0,15,9,9,9,9,9,9,9,9,9,9,9,9,9,9,9,9,15,0,12,0,8,15,0,15
15,0,15,15,0,11,0,0,15,10,15,15,15,15,15,15,15,15,15,15,15,15,10,15,0,0,12,0,15,15,0,15
15,0,11,0,0,15,0,8,0,15,10,10,10,10,10,10,10,10,10,10,10,10,15,0,8,0,15,0,0,12,0,15
15,0,11,0,8,8,8,15,0,0,15,15,15,15,15,15,15,15,15,15,15,15,0,0,15,8,8,8,0,12,0,15
15,0,11,0,15,15,15,11,0,0,0,0,0,11,0,0,0,0,12,0,0,0,0,0,12,15,15,15,0,12,0,15
15,0,15,13,3,0,0,11,0,0,0,0,0,11,8,8,8,8,12,0,0,0,0,0,12,0,0,6,14,15,0,15
15,8,0,0,0,0,0,11,0,0,0,0,8,15,15,15,15,15,15,8,0,0,0,0,12,0,0,0,0,0,8,15
15,15,0,0,0,0,8,15,8,8,8,8,15,11,0,0,0,0,12,15,8,8,8,8,15,8,0,0,0,0,15,15
15,8,8,0,0,8,15,0,15,15,15,15,0,11,0,8,8,0,12,0,15,15,15,15,0,15,8,0,0,8,8,15
15,15,15,0,0,15,0,0,0,0,0,0,0,11,8,15,15,8,12,0,0,0,0,0,0,0,15,0,0,15,15,15
15,0,0,0,8,8,8,8,8,8,8,0,0,11,15,0,0,15,12,0,0,8,8,8,8,8,8,8,0,0,0,15
15,0,0,0,15,15,15,15,15,15,15,0,0,15,0,0,0,0,15,0,0,15,15,15,15,15,15,15,0,0,0,15
15,1,0,0,0,15,13,8,8,8,8,8,8,0,0,4,0,0,0,8,8,8,8,8,8,14,15,0,0,0,7,15
15,15,15,10,10,15,15,15,15,15,15,15,15,10,10,10,10,10,10,15,15,15,15,15,15,15,15,10,10,15,15,15
