15,15,15,15,15,15,15,15,15,15,15,15,15,15,15,15,15,15,15,15,15,15,15,15,15,15,15,15,15,15,15,15
15,15,15,15,15,15,15,15,15,15,15,15,15,15,15,15,15,15,15,15,15,15,15,15,15,15,15,15,15,15,15,15
15,15,15,15,0,0,0,0,0,0,0,0,11,0,11,11,12,12,0,12,0,0,0,0,0,0,0,15,15,15,15,15
15,15,15,3,0,0,0,0,0,0,0,0,11,0,11,11,12,12,0,12,0,0,0,0,0,0,0,3,15,15,15,15
15,15,0,0,0,0,0,0,0,0,0,0,11,0,11,11,12,12,0,12,0,0,0,0,0,0,0,0,0,15,15,15
15,0,0,0,0,0,15,15,15,15,0,0,15,0,11,15,15,12,0,15,0,0,15,15,15,15,0,0,0,0,15,15
15,0,0,0,0,15,0,0,0,0,15,0,0,0,11,0,0,12,0,0,0,15,0,0,0,0,15,0,0,0,0,15
15,0,0,0,15,0,0,0,0,0,15,0,0,0,15,0,0,15,0,0,0,15,0,0,0,0,0,15,0,0,0,15
15,15,0,0,15,0,0,0,0,0,0,15,0,0,0,0,0,0,0,0,15,0,0,0,0,0,0,15,15,0,0,15
15,0,0,0,15,0,0,0,0,0,0,0,15,4,0,0,0,0,0,15,0,0,0,0,0,0,0,15,15,0,7,15
15,0,0,15,15,15,0,0,0,0,0,0,0,15,15,15,15,15,15,0,0,0,0,0,0,0,15,15,15,15,15,15
15,15,0,15,15,15,15,15,15,15,0,0,0,9,15,15,15,15,9,0,0,0,15,15,15,15,15,15,15,15,15,15
15,0,0,15,15,0,0,0,0,15,15,0,0,0,11,0,0,12,0,0,0,15,15,0,0,0,0,15,15,15,15,15
15,0,15,15,11,0,0,0,0,0,15,15,0,0,11,0,0,12,0,0,15,15,0,0,0,0,0,12,15,15,15,15
15,0,0,0,11,0,0,0,0,0,0,15,15,0,11,0,0,12,0,15,15,0,0,0,0,0,0,12,0,15,15,15
15,15,0,0,11,0,0,0,0,0,0,0,0,6,15,10,10,15,6,0,0,0,0,0,0,0,0,12,0,0,15,15
15,15,0,0,15,0,0,0,0,0,0,0,0,15,15,15,15,15,15,0,0,0,0,0,0,0,0,12,0,0,0,15
15,15,15,0,0,0,0,0,0,0,15,15,15,15,15,15,15,15,15,15,15,15,0,0,0,0,0,15,0,0,0,15
15,15,15,15,0,0,0,0,15,15,0,0,11,0,0,11,11,0,0,11,0,0,15,15,0,0,0,0,0,0,0,15
15,15,15,15,15,15,15,15,0,0,0,0,11,0,0,11,11,0,0,11,0,0,0,0,15,15,15,15,15,0,0,15
15,15,0,0,0,0,0,0,0,0,0,0,15,0,0,15,15,0,0,15,0,0,0,0,0,0,0,0,0,0,0,15
15,0,0,0,0,0,0,0,0,15,0,0,0,0,0,0,0,0,0,0,0,0,15,0,0,0,0,0,0,0,15,15
15,1,0,0,0,0,0,5,15,15,0,0,0,0,0,0,0,0,0,0,0,0,15,15,5,0,0,0,0,15,15,15
15,15,15,15,15,15,15,15,15,15,10,10,10,10,10,10,10,10,10,10,10,10,15,15,15,15,15,15,15,15,15,15
